111111111
1P0C01E01
100000001
111111111
